음악

여러 가지 음악 종류와 함께 음악과 관련한 영어 단어가 있습니다.



음악 전문용어



beat	박자

harmony	하모니

lyrics	가사

melody 또는 tune	멜로디

note	음표

rhythm	리듬

scale	음계

solo	독주

duet	합주

in tune	음에 맞춰서

out of tune	음이 맞지 않는

음악 기구



amp (amplifier 간략형)	증폭기

CD	CD

CD player	CD 플레이어

headphones	헤드폰

hi-fi 또는 hi-fi system	하이 파이

instrument	악기, 기구

mic (microphone 간략형)	마이크

MP3 player	MP3 플레이어

music stand	악보대

record player	레코드 플레이어

speakers	스피커

stereo 또는 stereo system	스테레오

음악 장르



blues	브루스

classical	클래식

country	컨트리

dance	댄스

easy listening	듣기 편안한 음악

electronic	전자 음악

folk	포크

heavy metal	헤비메탈

hip hop	힙팝

jazz	재즈

Latin	라틴

opera	오페라

pop	팝

rap	랩

reggae	레게

rock	락

techno	테크노

악단



band	밴드

brass band	금관악기로 구성된 악단

choir	합창단

concert band	콘서트 밴드

jazz band	재즈 밴드

orchestra	오케스트라

pop group	대중음악단

rock band	락밴드

string quartet	현악 사중단

영어 단어집

41쪽/65쪽 중

←	스포츠와 게임	악기	→

음악가



composer	작곡가

musician	음악가

performer	연주자

bassist 또는 bass player	베이스 연주자

cellist	첼로 연주자

conductor	지휘자

DJ	디제이

drummer	드러머

flautist	플룻 연주자

guitarist	기타리스트

keyboard player	키보드 연주자

organist	오르간 연주자

pianist	피아니스트

pop star	대중음악 가수

rapper	랩퍼

saxophonist	색소폰 연주자

trumpeter	트럼펫 연주자

trombonist	트럼본 연주자

violinist	바이올리니스트

singer	가수

alto	알토

soprano	소프라노

bass	베이스

tenor	테너

baritone	바리톤

음량



loud	시끄러운

quiet	조용한

soft	부드러운

다른 유용한 단어



to listen to music	음악을 듣다

to play an instrument	악기를 연주하다

to record	녹음하다

to sing	노래 부르다

audience	청중

concert	콘서트

hymn	찬송가

love song	사랑 노래

national anthem	애국가

symphony	교향곡

record	녹음, 음반

record label	음반 회사

recording	녹음

recording studio	녹음실

song	노래

stage	무대

track	한 곡

voice	목소리







악기

흔히 알려진 악기에 관한 영어 단어입니다.



건반 악기



accordion	아코디언

grand piano	그랜드 피아노

electronic keyboard (자주 keyboard로 생략 표기됨)	키보드

organ	오르간

piano	피아노

현악기



banjo	밴조

double bass	더블 베이스

cello	첼로

guitar	기타

acoustic guitar	어쿠스틱 기타

bass guitar 또는 bass	베이스 기타

classical guitar (Spanish guitar로 불리기도 함)	클래식 기타 (또는 스페인 기타라고도 불림)

electric guitar	전기 기타

harp	하프

ukulele	우쿨렐레

viola	비올라

violin	바이올린

금관악기



bugle	나팔

cornet	코넷

horn 또는 French horn	프렌치 호른

trombone	트롬본

trumpet	트럼펫

tuba	튜바

영어 단어집

42쪽/65쪽 중

←	음악	건강	→

목관악기



bagpipes	백파이프

bassoon	바순

clarinet	클라리넷

flute	플룻

harmonica 또는 mouth organ	하모니카

oboe	오보에

piccolo	피콜로

recorder	리코더

saxophone	섹소폰

타악기



bass drum	베이스 드럼

cymbals	심벌즈

drums	드럼

drum kit	드럼 세트

gong	징

snare drum	뒷면에 쇠 울림줄을 댄 작은 북

tambourine	탬버린

triangle	트라이앵글

xylophone	실로폰